42,44,44,44,44,44,44,44,44,44,44,44,44,44,44,44,44,44,44,44,44,44,44,44,44,44,44,44,44,44,44,44,44,44,44,44,44,44,44,44,44,44,44,44,44,44,44,44,44,44,44,44,44,44,44,44,44,44,44,44,44,44,44,44,44,44,44,44,44,44,44,44,44,44,44,44,44,44,44,44,44,44,44,44,44,44,44,44,44,44,44,44,44,44,44,44,44,44,44,44,44,44,44,44,44,44,44,44,44,44,44,44,44,44,44,44,44,44,44,42
30,51,51,51,51,51,51,51,51,51,48,49,50,48,49,50,48,49,50,48,49,50,48,49,50,48,49,50,48,49,50,48,49,50,48,49,50,48,49,50,48,49,50,48,49,50,48,49,50,48,49,50,48,49,50,48,49,50,48,49,50,48,49,50,48,49,50,48,49,50,48,49,50,48,49,50,48,49,50,48,49,50,48,49,50,48,49,50,48,49,50,48,49,50,48,49,50,48,49,50,48,49,50,48,49,50,48,49,50,48,49,50,48,49,50,48,49,50,48,30
30,51,51,51,51,51,49,50,48,49,50,48,49,50,48,49,54,55,56,54,55,56,54,55,56,54,55,56,54,55,56,54,55,56,54,55,56,54,55,56,54,55,56,54,55,56,54,55,56,54,55,56,54,55,56,54,55,56,54,55,56,54,55,56,54,55,56,54,55,56,54,55,56,54,55,56,54,55,56,54,55,56,54,55,56,54,55,56,54,55,56,54,55,56,54,55,56,54,55,56,54,55,56,54,55,56,54,55,56,54,55,56,54,55,56,54,55,56,54,30
30,48,49,50,48,49,55,56,54,55,56,54,55,56,54,55,48,49,50,48,49,50,48,49,50,48,49,50,48,49,50,48,49,50,48,49,50,48,49,50,48,49,50,48,49,50,48,49,50,48,49,50,48,49,50,48,49,50,48,49,50,48,49,50,48,49,50,48,49,50,48,49,50,48,49,50,48,49,50,48,49,50,48,49,50,48,49,50,48,49,50,48,49,50,48,49,50,48,49,50,48,49,50,48,49,50,48,49,50,48,49,50,48,49,50,48,49,50,48,30
30,49,50,48,49,50,49,50,48,49,50,48,49,50,48,49,54,55,56,54,55,56,54,55,56,54,55,56,54,55,56,54,55,56,54,55,56,54,55,56,54,55,56,54,55,56,54,55,56,54,55,56,54,55,56,54,55,56,54,55,56,54,55,56,54,55,56,54,55,56,54,55,56,54,55,56,54,55,56,54,55,56,50,48,50,48,49,50,48,49,50,48,49,50,48,49,50,48,49,50,48,49,50,48,49,50,48,49,50,48,49,50,48,49,50,48,49,56,54,30
30,49,50,48,49,50,55,56,54,55,56,54,55,56,54,55,48,49,50,48,49,50,48,49,50,48,49,50,48,49,50,48,49,50,48,49,50,48,49,50,48,49,50,48,49,50,48,49,50,48,49,50,48,49,50,48,49,50,48,49,50,48,49,50,48,49,50,48,49,50,48,49,50,48,49,50,48,49,50,48,49,50,56,54,56,54,55,56,54,55,56,54,55,56,54,55,56,54,55,56,54,55,56,54,55,56,54,55,56,54,55,56,54,55,56,54,55,50,48,30
30,55,56,54,55,56,49,50,48,49,50,48,49,50,48,49,54,55,56,54,55,56,54,55,56,54,55,56,54,55,56,54,55,56,54,55,56,54,55,56,54,55,56,54,55,56,54,55,56,54,55,56,54,55,56,54,55,56,54,55,56,54,55,56,54,55,56,54,55,56,54,55,56,54,55,56,54,55,56,54,55,56,50,48,50,48,49,50,48,49,50,48,49,50,48,49,50,48,49,50,48,49,50,48,54,55,56,54,55,48,49,50,48,49,50,48,49,56,54,30
30,49,50,48,49,50,55,56,54,55,56,54,55,56,54,55,48,49,50,48,49,50,48,49,50,48,49,50,48,49,50,48,49,50,48,49,50,48,49,50,48,49,50,48,49,50,48,49,50,48,49,50,48,49,50,48,49,50,48,49,50,48,49,50,48,49,50,48,49,50,48,49,50,48,49,50,48,49,50,48,49,50,48,49,50,48,49,50,48,49,50,48,49,50,48,49,50,48,49,50,48,49,50,48,54,55,56,54,55,48,49,50,48,49,50,48,49,50,48,30
30,55,56,54,55,56,50,48,49,48,49,50,48,49,50,48,48,55,56,54,55,56,54,55,56,54,55,56,54,55,56,54,55,56,54,55,56,54,55,56,54,55,56,54,55,56,54,55,56,54,55,56,54,55,56,54,55,56,54,55,56,54,55,56,54,55,56,54,55,56,54,55,56,54,55,56,54,55,56,54,55,56,54,55,56,54,55,56,54,55,56,54,55,56,54,55,56,54,55,56,54,55,56,54,54,55,56,54,55,54,55,56,54,55,56,54,55,56,54,30
30,49,50,48,49,50,56,54,55,48,49,50,48,49,50,48,54,49,50,48,49,50,48,49,50,48,49,50,48,49,50,48,49,50,48,49,50,48,49,50,48,49,50,48,49,50,48,49,50,48,49,50,48,49,50,48,49,50,48,49,50,48,49,50,48,49,50,48,49,50,48,49,50,48,49,50,48,49,50,48,49,50,48,49,50,48,49,50,48,49,50,48,49,50,48,49,50,48,49,50,48,49,50,48,54,55,56,54,55,48,49,50,48,49,50,48,49,50,48,30
30,55,56,54,55,56,50,48,49,48,48,49,50,48,49,50,48,55,48,49,50,48,49,50,48,49,50,48,49,50,48,49,50,48,49,50,48,49,50,48,49,50,48,49,50,48,49,50,48,49,50,48,49,50,48,49,55,56,54,55,56,54,55,56,54,55,56,54,55,56,54,55,56,54,55,56,54,55,56,54,55,56,54,55,56,54,55,56,54,55,56,54,55,56,54,55,56,54,55,56,54,55,56,54,54,55,56,54,55,54,55,56,54,55,56,54,55,56,54,30
30,50,48,49,50,48,56,54,55,54,48,49,50,48,49,50,48,49,48,49,50,48,49,50,48,48,49,50,48,56,54,55,56,54,55,56,54,55,56,54,55,56,54,55,56,54,55,56,54,55,56,54,55,56,54,55,49,50,48,49,50,48,49,50,48,49,50,48,49,50,48,49,50,48,49,50,48,49,50,48,49,50,48,49,50,48,49,50,48,49,50,48,49,50,48,49,50,48,49,50,48,49,50,48,54,55,56,54,55,48,49,50,48,49,50,48,49,50,48,30
30,56,54,55,56,54,50,48,49,49,48,49,50,48,49,50,48,55,48,49,50,48,49,50,48,54,54,55,56,54,55,56,54,55,56,54,55,54,54,48,49,50,48,49,50,48,49,50,48,49,50,48,49,50,48,49,55,56,54,55,56,54,55,56,54,55,56,54,55,56,54,55,56,54,55,56,54,55,56,54,55,56,54,55,56,54,55,56,54,55,56,54,54,54,55,56,54,55,55,56,54,55,56,54,55,56,54,55,55,54,55,56,54,55,56,54,55,56,54,30
30,50,48,49,50,48,56,54,55,55,48,49,50,48,49,50,48,49,48,49,50,48,49,50,48,48,54,54,55,56,54,55,56,54,55,56,54,55,54,54,48,49,50,48,49,50,48,49,50,48,49,50,48,49,50,48,49,50,48,49,50,48,49,50,48,49,50,48,49,50,48,49,50,48,49,50,48,50,48,49,50,48,49,50,48,49,50,48,49,50,48,49,48,54,54,55,56,54,55,55,49,50,48,54,55,56,54,55,49,49,49,50,48,49,50,48,49,50,48,30
30,56,54,55,56,54,50,48,49,50,48,49,50,48,49,50,48,55,48,49,50,48,49,50,48,54,48,54,54,55,56,54,55,56,54,55,56,54,55,54,54,55,56,54,55,56,54,55,56,54,55,56,54,55,56,54,55,56,54,55,56,54,55,54,54,54,54,54,54,54,54,54,54,54,54,54,55,56,54,55,56,54,55,56,54,55,56,54,55,56,54,55,54,48,54,55,56,54,55,49,55,55,55,55,54,55,55,49,55,55,55,56,54,55,56,54,55,56,54,30
30,50,48,49,50,48,50,48,49,50,48,48,49,50,48,49,50,48,48,49,50,48,49,50,48,50,54,48,54,54,54,55,56,54,55,56,54,55,56,54,54,54,54,54,54,54,54,54,54,54,54,54,54,54,54,54,54,54,54,54,54,54,54,48,48,48,48,48,48,48,48,48,48,48,48,54,54,54,54,54,55,56,54,55,56,54,55,56,54,55,56,54,48,54,48,54,55,56,54,55,49,49,49,49,55,55,49,55,49,49,49,50,48,49,50,48,49,50,48,30
42,56,54,55,56,54,56,54,55,56,54,48,49,50,48,49,50,48,48,49,50,48,49,50,48,48,50,54,48,48,54,54,54,55,56,54,55,56,54,55,48,48,48,54,54,54,54,54,54,48,48,48,48,48,48,48,48,48,48,48,48,48,48,54,54,54,54,54,54,54,54,54,54,54,54,48,48,48,48,48,49,50,48,49,54,55,56,54,55,56,54,55,56,54,55,56,54,55,56,54,55,55,55,55,49,49,55,49,55,54,55,56,54,55,56,54,55,56,54,42
30,50,48,49,50,48,50,48,49,50,49,48,49,50,48,49,50,48,48,49,50,48,49,50,48,54,50,48,54,54,48,48,54,54,55,56,54,55,56,54,54,54,54,54,54,54,54,54,54,54,54,54,54,54,54,54,54,54,54,54,54,54,54,54,55,56,54,55,56,54,55,56,54,55,56,54,54,54,54,54,55,56,54,55,54,55,56,54,55,56,54,55,56,54,55,56,54,54,55,56,54,55,49,49,55,55,49,55,49,48,49,50,48,49,50,48,49,50,48,30
30,50,48,49,50,48,56,54,55,56,55,48,48,49,50,48,49,48,49,50,48,49,50,48,48,49,50,48,49,50,54,54,48,48,54,54,54,54,54,54,54,55,56,54,55,56,54,55,56,54,55,56,54,54,56,54,55,56,54,55,56,54,55,56,54,55,56,54,56,54,55,56,54,55,56,54,55,56,54,55,56,54,55,56,48,49,50,48,49,50,48,49,50,48,49,50,48,54,54,55,56,54,55,55,49,49,55,49,55,54,55,56,54,55,56,54,55,56,54,30
30,56,54,55,56,54,50,48,49,50,48,54,48,49,50,48,49,48,49,50,48,49,50,48,54,55,50,48,49,50,48,48,54,54,48,48,48,48,48,48,54,54,55,56,54,55,56,54,55,56,54,55,56,54,50,48,49,50,48,49,50,48,49,50,48,49,50,48,50,48,49,50,48,49,50,48,49,50,48,49,50,48,49,50,54,55,56,54,55,56,54,55,56,54,55,56,54,48,54,54,55,56,54,55,55,55,49,55,49,48,49,50,48,49,50,48,49,50,48,30
30,50,48,49,50,48,56,54,55,56,54,49,48,48,49,50,48,49,50,48,49,50,48,48,49,55,50,48,49,50,48,56,54,55,56,54,54,54,54,54,54,55,56,54,55,56,54,55,56,54,55,56,54,55,56,54,55,56,54,55,56,54,55,56,54,55,56,54,55,56,54,55,56,54,55,56,54,55,56,54,55,56,54,55,56,54,56,54,55,56,56,54,54,49,55,54,48,54,48,54,54,55,56,54,55,49,55,49,55,54,55,56,54,55,56,54,55,56,54,30
30,56,54,55,56,54,50,48,49,50,48,55,54,48,48,48,48,49,50,48,49,50,48,48,55,55,50,48,49,50,48,54,55,56,54,49,55,55,55,55,55,55,55,55,56,54,55,56,54,55,49,50,48,49,50,48,49,50,48,49,50,48,49,50,48,49,50,48,49,50,48,49,50,48,49,50,48,49,50,48,49,50,48,49,50,48,54,55,56,54,50,48,48,54,49,49,54,48,54,48,54,55,56,54,55,55,49,55,49,48,49,50,48,49,50,48,49,50,48,30
30,50,48,49,50,48,49,50,48,49,50,48,49,54,54,48,49,50,48,49,50,48,54,48,54,55,48,49,50,48,48,55,56,54,55,49,55,55,55,55,55,55,55,55,56,54,55,56,54,55,49,50,48,49,50,48,49,50,48,49,50,48,49,50,48,49,50,48,49,50,48,49,50,48,49,50,48,49,50,48,49,50,48,49,50,48,55,56,54,55,56,54,54,48,54,55,49,54,48,54,48,54,55,56,54,55,55,49,55,54,55,56,54,55,56,54,55,56,54,30
30,56,54,55,56,54,55,56,54,55,56,54,55,49,49,48,49,50,48,49,50,48,49,48,54,55,54,49,50,48,54,48,42,44,44,44,44,44,44,44,44,44,44,44,44,44,44,44,44,44,44,44,44,44,44,44,44,44,44,44,44,44,44,44,44,44,44,44,44,44,44,44,44,44,44,44,44,44,44,44,44,44,44,44,44,44,44,44,44,42,50,48,48,54,48,49,55,49,54,48,54,48,54,55,56,54,55,55,49,48,49,50,48,49,50,48,49,50,48,30
30,50,48,49,50,48,49,50,48,49,50,48,49,55,55,48,49,50,48,49,50,48,55,48,54,55,49,49,50,48,49,54,30,55,55,56,54,55,56,54,55,54,55,55,55,55,55,49,49,55,55,56,54,55,56,31,32,33,54,55,56,54,55,56,54,55,56,54,55,56,54,55,56,54,55,56,54,55,56,54,25,26,27,55,56,54,55,56,54,30,56,54,54,48,54,54,49,55,49,54,48,54,54,55,56,54,55,49,55,54,55,56,54,55,56,54,55,56,54,30
30,49,50,48,49,50,55,56,54,55,56,54,55,56,54,48,49,50,48,49,50,48,55,48,54,55,55,49,50,48,55,48,30,49,55,55,56,54,55,56,54,55,49,49,49,49,49,55,55,49,49,50,48,49,50,37,38,39,48,49,50,48,49,50,48,49,50,48,49,50,48,49,50,48,49,50,48,49,50,48,31,32,33,49,50,48,49,50,48,30,50,48,48,54,48,48,54,49,55,49,54,48,54,54,55,56,54,55,49,48,49,50,48,49,50,48,49,50,48,30
30,55,56,54,55,56,49,50,48,49,50,48,49,50,48,48,49,50,48,49,50,48,55,48,56,54,55,49,50,48,56,54,30,55,49,55,56,54,55,56,54,55,55,55,55,55,55,49,49,55,55,56,54,55,56,54,55,56,54,55,56,54,55,56,54,55,56,54,55,56,54,55,56,54,55,56,54,55,56,54,37,38,39,55,56,54,55,56,54,30,56,54,54,48,54,54,48,54,49,55,49,54,48,54,54,55,56,54,55,49,50,48,49,50,48,49,50,48,54,30
30,49,50,48,49,50,48,49,50,48,49,55,55,48,49,48,49,50,48,49,50,48,55,54,56,54,55,49,50,48,50,48,30,49,55,55,56,54,55,56,54,55,54,55,56,54,55,55,55,48,49,50,48,49,50,48,49,50,48,49,50,48,49,50,48,49,50,48,49,50,48,49,50,48,49,50,48,49,50,48,49,50,48,49,50,48,49,50,48,30,50,48,48,54,48,48,54,48,54,49,55,49,54,48,54,55,56,54,55,55,56,54,55,56,54,55,56,54,48,30
30,55,56,54,55,56,54,55,56,54,55,49,49,54,48,49,50,48,49,50,48,48,55,49,56,54,55,48,48,48,56,54,30,55,49,55,56,54,55,56,54,55,1,2,2,2,2,2,2,2,3,56,54,55,56,54,55,56,54,55,56,54,55,56,54,55,56,54,55,56,54,55,56,54,55,56,54,55,56,54,55,56,54,55,56,54,55,56,54,30,56,54,54,48,54,54,48,54,48,54,49,55,48,54,55,56,54,55,55,49,50,48,49,50,48,49,50,48,54,30
30,49,50,48,49,50,48,49,50,48,49,49,50,48,48,49,50,48,49,50,48,48,55,55,56,54,55,54,48,54,50,48,30,50,55,55,56,54,55,56,54,55,7,8,8,8,8,8,8,8,9,50,48,49,50,48,49,50,48,49,50,48,49,50,48,49,50,48,49,50,48,49,50,48,49,50,48,49,50,48,49,50,48,49,50,48,49,50,48,30,50,48,48,54,48,48,54,48,54,48,54,49,54,54,55,56,54,55,49,55,56,54,55,56,54,55,56,54,48,30
30,54,55,56,54,55,56,54,55,56,54,55,56,48,48,49,50,48,49,48,49,50,48,49,50,48,55,49,48,49,56,54,30,56,54,55,55,56,54,55,56,54,55,8,8,8,8,8,8,8,9,56,54,55,56,54,55,56,54,55,56,54,55,56,54,55,56,54,55,56,54,55,56,54,55,56,54,55,56,54,55,56,54,55,56,54,55,56,54,30,56,54,48,48,54,54,48,54,48,54,48,54,49,54,55,56,54,55,55,49,50,48,49,50,48,49,50,48,54,30
30,48,49,50,48,49,50,48,49,50,48,49,50,54,48,49,50,48,49,48,48,49,50,48,49,50,48,55,54,55,50,48,30,50,48,49,55,56,54,55,56,54,55,8,8,8,8,8,8,8,9,50,48,49,50,48,49,50,48,49,50,48,49,50,48,49,50,48,49,50,48,49,50,48,49,50,48,49,50,48,49,50,48,49,50,48,49,50,48,30,50,48,49,50,48,48,54,48,54,48,54,48,55,54,55,56,54,55,49,55,56,54,55,56,54,55,56,54,48,30
30,54,55,56,54,55,56,54,55,56,54,55,56,49,48,49,50,48,49,54,48,49,50,48,49,50,48,49,50,48,56,54,30,56,54,55,55,56,54,55,56,54,55,8,8,8,8,8,8,8,9,56,54,55,56,54,55,56,54,55,56,54,55,56,54,55,56,54,55,56,54,55,56,54,55,56,54,55,56,54,55,56,54,55,56,54,55,56,54,30,56,54,55,56,54,54,48,54,48,54,48,54,49,54,55,56,54,55,55,49,50,48,49,50,48,49,50,48,54,30
30,48,49,50,48,49,50,48,49,50,48,49,50,55,48,48,49,50,48,49,48,49,50,48,49,50,48,49,50,48,50,48,30,50,48,55,56,54,55,56,54,55,55,8,8,8,8,8,8,8,9,50,48,49,50,48,49,50,48,49,50,48,49,50,48,49,50,48,49,50,48,49,50,48,49,50,48,49,50,48,49,50,48,49,50,48,49,50,48,30,50,48,49,50,48,48,54,48,54,48,54,48,54,54,55,56,54,55,49,48,49,50,48,49,50,48,49,50,48,30
30,54,55,56,54,55,56,54,55,56,54,55,56,55,54,48,49,50,48,55,48,49,50,48,49,50,48,49,50,48,56,54,30,56,54,55,56,54,55,56,54,55,49,8,8,8,8,8,8,8,9,56,54,55,56,54,55,56,54,55,56,54,55,56,54,55,56,54,55,56,54,55,56,54,55,56,54,55,56,54,55,56,54,55,56,54,55,56,54,30,56,54,55,56,54,55,48,54,48,54,48,54,48,54,55,56,54,55,55,54,55,56,54,55,56,54,55,56,54,30
30,48,49,50,48,49,50,48,49,50,48,49,50,55,49,48,49,50,54,55,48,48,49,48,49,50,48,49,50,48,50,48,30,50,48,55,56,54,55,56,54,55,55,8,8,8,8,8,8,8,9,50,48,49,50,48,49,50,48,49,50,48,49,50,48,49,50,48,49,50,48,49,50,48,49,50,48,49,50,48,49,50,48,49,50,48,49,50,48,30,50,48,49,50,48,49,50,48,54,48,54,48,54,54,55,56,54,55,49,48,49,50,48,49,50,48,49,50,48,30
30,54,55,56,54,55,56,54,55,56,54,55,56,55,55,48,49,50,49,55,54,48,49,48,49,50,48,49,50,48,56,54,30,56,54,55,56,54,55,56,54,55,49,8,8,8,8,8,8,8,9,56,54,55,56,54,55,56,54,55,56,54,55,56,54,55,56,54,55,56,54,55,56,54,55,56,54,55,56,54,55,56,54,55,56,54,55,56,54,30,56,54,55,56,54,55,56,54,48,54,48,54,48,54,55,56,54,55,55,54,55,56,54,55,56,54,55,56,54,30
30,48,49,50,48,49,50,48,49,50,48,49,50,55,56,48,49,50,55,56,49,48,49,48,49,50,48,49,50,48,50,48,30,50,48,49,50,48,49,50,48,49,55,8,8,8,8,8,8,8,9,50,48,49,50,48,49,50,48,49,50,48,49,50,48,49,50,48,49,50,48,49,50,48,49,50,48,49,50,48,49,50,48,49,50,48,49,50,48,30,50,48,49,50,48,49,50,48,49,48,54,48,54,54,55,56,54,55,49,48,49,50,48,49,50,48,49,50,48,30
30,54,55,56,54,55,56,54,55,56,54,55,56,55,56,54,48,49,55,56,55,48,48,49,50,48,49,50,48,48,56,54,30,56,54,55,56,54,55,56,54,55,7,8,8,8,8,8,8,8,9,56,54,55,56,54,55,56,54,55,56,54,55,56,54,55,56,54,55,56,54,55,56,54,55,56,54,55,56,54,55,56,54,55,56,54,55,56,54,30,56,54,55,56,54,55,56,54,55,56,48,54,54,55,56,54,55,55,55,54,55,56,54,55,56,54,55,56,54,30
30,48,49,50,48,49,50,48,49,50,48,49,50,55,56,49,48,49,55,56,54,48,48,49,50,48,49,50,48,54,50,48,30,50,48,49,50,48,49,50,48,49,7,8,8,8,8,8,8,8,9,50,48,49,50,48,49,50,48,49,50,48,49,50,48,49,50,48,49,50,48,49,50,48,49,50,48,49,50,48,49,50,48,49,50,48,49,50,48,30,50,48,49,50,48,49,50,48,49,50,48,48,54,55,56,54,55,49,49,48,49,50,48,49,50,48,49,50,48,30
30,54,55,56,54,55,56,54,55,56,54,55,56,55,56,55,48,49,55,56,54,48,48,49,50,48,49,50,48,49,56,54,30,56,54,55,56,54,55,56,54,55,44,44,44,44,44,44,44,44,44,56,54,55,56,54,55,56,54,55,56,54,55,56,54,55,56,54,55,56,54,55,56,54,55,56,54,55,56,54,55,56,54,55,56,54,55,56,54,30,56,54,55,56,54,55,56,54,55,56,54,54,55,56,54,55,55,55,55,54,55,56,54,55,56,54,55,56,54,30
30,48,49,50,48,50,48,49,50,48,49,50,48,55,56,54,48,49,55,56,54,54,48,49,50,48,49,50,48,55,50,48,30,50,48,49,50,48,49,50,48,49,7,8,8,8,8,8,8,8,9,50,48,49,50,48,49,50,48,49,50,48,49,50,48,49,50,48,49,50,48,49,50,48,49,50,48,49,50,48,49,25,26,27,50,48,49,50,48,30,50,48,49,54,55,56,54,55,55,55,55,55,56,54,55,55,49,49,49,48,49,50,48,49,50,48,49,50,48,30
30,54,55,56,54,56,54,55,56,54,55,56,54,55,55,56,48,48,55,56,54,49,48,49,50,48,49,50,48,55,56,54,30,56,54,55,56,54,55,56,54,55,7,8,8,8,8,8,8,8,9,56,54,55,56,54,55,56,54,55,56,54,55,56,54,55,56,54,55,56,54,55,56,54,55,56,54,55,56,54,55,31,32,33,56,54,55,56,54,30,56,54,55,48,49,50,48,49,49,49,49,49,55,55,55,49,55,55,55,54,55,56,54,55,56,54,55,56,54,30
30,48,49,50,48,50,48,49,50,48,49,50,48,49,55,56,54,48,55,56,54,55,48,49,50,48,49,50,48,49,50,48,30,50,48,49,50,48,49,50,48,49,7,8,8,8,8,8,8,8,9,50,48,49,50,48,49,50,48,49,50,48,49,50,48,49,50,48,49,50,48,49,50,48,49,50,48,49,50,48,49,37,38,39,50,48,49,50,48,30,50,48,49,54,55,56,54,55,55,55,55,55,49,49,49,55,49,49,49,48,49,50,48,49,50,48,49,50,48,30
30,54,55,56,54,56,54,55,56,54,55,56,54,55,55,56,49,48,55,56,54,55,48,49,50,48,49,50,48,55,56,54,30,56,54,55,56,54,55,56,54,55,7,8,8,8,8,8,8,8,9,56,54,55,56,54,55,56,54,55,56,54,55,56,54,55,56,54,55,56,54,55,56,54,55,56,54,55,56,54,55,56,54,55,56,54,55,56,54,30,56,54,55,48,49,50,48,49,49,49,49,49,55,55,55,49,55,55,55,54,55,56,54,55,56,54,55,56,54,30
30,48,49,50,48,50,48,49,50,48,49,50,48,49,55,56,55,48,55,56,54,55,48,49,50,48,49,50,48,49,50,48,30,50,48,49,50,48,49,50,48,49,7,8,8,8,8,8,8,8,9,50,48,49,50,48,49,50,48,49,50,48,49,50,48,49,50,48,49,50,48,49,50,48,49,50,48,49,50,48,49,50,48,49,50,48,49,50,48,30,50,48,49,54,55,56,54,55,55,55,55,55,49,49,49,55,49,49,49,48,49,50,48,49,50,48,49,50,48,30
30,54,55,56,54,56,54,55,56,54,55,56,54,55,55,56,54,48,48,55,56,54,48,49,50,48,49,50,48,55,56,54,30,56,54,55,56,54,55,56,54,55,7,8,8,8,8,8,8,8,9,56,54,55,56,54,55,56,54,55,56,54,55,56,54,55,56,54,55,56,54,55,56,54,55,56,54,55,56,54,55,56,54,55,56,54,55,56,54,30,56,54,55,49,49,50,48,49,49,49,49,49,55,55,55,49,55,55,56,54,55,56,54,55,56,54,55,56,54,30
30,48,49,50,48,50,48,49,50,48,49,50,48,49,55,56,54,54,48,55,56,54,48,49,50,48,49,50,48,49,50,48,30,50,48,49,50,48,49,50,48,49,13,14,14,14,14,14,14,14,15,50,48,49,50,48,49,50,48,49,50,48,49,50,48,49,50,48,49,50,48,49,50,48,49,50,48,49,50,48,49,50,48,49,50,48,49,50,48,30,50,48,49,55,55,56,54,55,55,55,55,55,49,49,49,55,49,49,50,48,49,50,48,49,50,48,49,50,48,30
30,50,48,49,50,50,48,49,50,48,49,50,48,49,55,56,54,49,54,55,56,54,48,49,50,48,49,50,48,55,56,54,30,56,54,55,56,54,55,56,54,55,56,54,55,56,54,55,56,54,55,56,54,55,56,54,55,56,54,55,56,54,55,56,54,55,56,54,55,56,54,55,56,54,55,56,54,55,56,54,55,56,54,55,56,54,55,56,54,30,56,54,55,49,49,50,48,49,49,49,49,49,55,55,55,49,55,55,50,48,49,50,48,49,50,48,55,56,54,30
30,56,54,55,56,56,54,55,56,54,55,56,54,55,55,56,54,55,49,55,56,54,48,49,48,49,50,48,49,50,48,48,30,50,48,49,50,48,49,50,48,49,50,48,49,50,48,49,50,48,49,50,48,49,50,48,49,50,48,49,50,48,49,50,48,49,50,48,49,50,48,49,50,48,49,50,48,49,50,48,49,50,48,49,50,48,49,50,48,30,50,48,49,54,55,56,54,55,55,55,55,55,49,49,49,55,49,49,50,48,49,50,48,49,50,48,49,50,48,30
30,50,48,49,50,50,48,49,50,48,49,50,48,49,55,56,54,55,55,55,56,54,48,49,54,55,56,54,55,56,54,54,30,56,54,55,56,54,55,56,54,55,56,54,55,56,54,55,56,54,55,56,54,55,56,54,55,56,54,55,56,54,55,56,54,55,56,54,55,56,54,55,56,54,55,56,54,55,56,54,55,56,54,55,56,54,55,56,54,30,56,54,55,48,49,50,48,49,49,49,49,49,55,55,55,49,55,55,56,54,55,56,54,55,56,54,55,56,54,30
42,56,54,55,56,56,54,55,56,54,55,56,54,55,55,56,54,55,56,54,55,49,48,49,49,50,48,49,50,48,49,44,42,44,44,44,44,44,44,44,44,44,44,44,44,44,44,44,44,44,44,44,44,44,44,44,44,44,44,44,44,44,44,44,44,44,44,44,44,44,44,44,44,44,44,44,44,44,44,44,44,44,44,44,44,44,44,44,44,42,44,44,44,54,55,56,54,55,55,55,55,55,49,49,49,55,49,49,50,48,49,50,48,49,50,48,49,50,48,42
30,50,48,49,50,50,48,49,50,48,49,50,48,49,48,55,56,54,55,56,54,55,48,48,55,56,54,55,56,54,55,54,55,56,54,55,56,54,55,56,54,55,56,54,55,56,54,55,56,54,55,50,48,49,50,48,49,50,48,49,50,48,55,56,54,55,56,54,55,56,54,55,56,54,55,56,54,55,56,54,55,56,54,55,56,54,55,56,54,55,56,54,55,48,49,50,48,49,49,49,49,49,55,55,55,49,55,55,56,54,55,56,54,55,56,54,55,56,54,30
30,56,54,55,56,56,54,55,56,54,55,56,54,55,48,55,56,54,55,56,54,55,54,48,49,50,48,49,50,48,50,48,49,50,48,49,50,48,49,50,48,49,50,48,49,50,48,49,50,48,49,56,54,55,56,54,55,56,54,55,56,54,49,50,48,49,50,48,49,50,48,49,50,48,49,50,48,49,50,48,49,50,48,49,50,48,49,50,48,49,50,48,49,54,55,56,54,55,55,55,55,55,49,49,49,55,49,49,50,48,49,50,48,49,50,48,49,50,48,30
30,50,48,49,50,50,48,49,50,48,49,50,48,49,54,55,56,54,55,56,54,55,49,54,55,56,54,55,56,54,56,54,55,56,54,55,56,54,55,56,54,55,56,54,55,56,54,55,56,54,55,50,48,49,50,48,49,50,48,49,50,48,55,56,54,55,56,54,55,56,54,55,56,54,55,56,54,55,56,54,55,56,54,55,56,54,55,56,54,55,56,54,55,48,49,50,48,49,49,49,49,49,55,55,55,49,55,55,56,54,55,56,54,55,56,54,55,56,54,30
30,48,49,50,48,49,50,48,49,50,48,49,50,48,49,55,56,54,55,56,54,55,55,49,50,48,49,50,48,49,50,48,49,50,48,49,50,48,49,50,48,49,50,48,49,50,48,49,50,48,49,56,54,55,56,54,55,56,54,55,56,54,49,50,48,49,50,48,49,50,48,49,50,48,49,50,48,49,50,48,49,50,48,49,50,48,49,50,48,49,50,48,49,54,55,56,54,55,55,55,55,55,49,49,49,55,49,49,50,48,49,50,48,49,50,48,49,50,48,30
30,54,55,56,54,55,56,54,55,56,54,55,56,54,55,55,56,54,55,56,54,55,54,55,56,54,55,56,54,55,56,54,55,56,54,55,56,54,55,56,54,55,56,54,55,56,54,55,56,54,55,50,48,49,50,48,49,50,48,49,50,48,55,56,54,55,56,54,55,56,54,55,56,54,55,56,54,55,56,54,55,56,54,55,56,54,55,50,48,49,50,48,49,48,49,50,48,49,49,49,49,49,55,55,55,49,55,48,48,54,55,56,54,55,56,54,55,56,54,30
30,48,49,50,48,49,50,48,49,50,48,49,50,48,49,50,48,49,50,48,49,50,48,49,50,48,49,50,48,49,50,48,49,50,48,49,50,48,49,50,48,49,50,48,49,50,48,49,50,48,49,56,54,55,56,54,55,56,54,55,56,54,49,50,48,49,50,48,49,50,48,49,50,48,49,50,48,49,50,48,49,50,48,49,50,48,49,56,54,55,56,54,55,54,55,56,54,55,55,55,55,55,49,49,49,55,49,54,54,48,49,50,48,49,50,48,49,50,48,30
30,54,55,56,54,55,56,54,55,56,54,55,56,54,55,56,54,55,56,54,55,56,54,55,56,54,55,56,54,55,56,54,55,56,54,55,56,54,55,56,54,55,56,54,55,56,54,55,56,54,55,50,48,49,50,48,49,50,48,49,50,48,55,56,54,55,56,54,55,56,54,55,56,54,55,56,54,55,56,54,55,56,54,55,56,54,55,50,48,49,50,48,49,48,49,50,48,49,49,49,49,49,55,55,55,49,48,48,48,54,55,56,54,55,56,54,55,56,54,30
30,48,49,50,48,49,50,48,49,50,48,49,50,48,49,50,48,49,50,48,49,50,48,49,50,48,49,50,48,49,50,48,49,50,48,49,50,48,49,50,48,49,50,48,49,50,48,49,50,48,49,50,48,49,50,48,49,50,48,49,50,48,49,50,48,49,50,48,49,50,48,49,50,48,49,50,48,49,50,48,49,50,48,49,50,48,49,56,54,55,56,54,55,56,54,55,56,48,49,50,48,49,49,49,49,54,54,54,54,48,49,50,48,49,50,48,49,50,48,30
30,54,55,56,54,55,56,54,55,56,54,55,56,54,55,56,54,55,56,54,55,56,54,55,56,54,55,56,54,55,56,54,55,56,54,55,56,54,55,56,54,55,56,54,55,56,54,55,56,54,55,56,54,55,56,54,55,56,54,55,56,54,55,56,54,55,56,54,55,56,54,55,56,54,55,56,54,55,56,54,55,56,54,55,56,54,55,50,48,49,50,48,49,50,48,49,50,48,48,48,48,48,48,48,48,48,48,48,48,54,55,56,54,55,56,54,55,56,54,30
30,48,49,50,48,49,50,48,49,50,48,49,50,48,49,50,48,49,50,48,49,50,48,49,50,48,49,50,48,49,50,48,49,50,48,49,50,48,49,50,48,49,50,48,49,50,48,49,50,48,49,50,48,49,50,48,49,50,48,49,50,48,49,50,48,49,50,48,49,50,48,49,50,48,49,50,48,49,50,48,49,50,48,49,50,48,49,56,54,55,56,54,55,56,54,55,56,54,54,54,54,54,54,54,54,54,54,54,54,48,49,50,48,49,50,48,49,50,48,30
30,54,55,56,54,55,56,54,55,56,54,55,56,54,55,56,54,55,56,54,55,56,54,55,56,54,55,56,54,55,56,54,55,51,54,55,56,54,55,56,54,55,56,54,55,56,54,55,56,54,55,56,54,55,56,54,55,56,54,55,56,54,55,56,54,55,56,54,55,56,54,55,56,54,55,56,54,55,56,54,55,56,54,55,56,54,55,50,48,49,50,48,49,50,48,49,50,48,48,48,48,48,48,48,48,48,48,48,48,54,55,56,54,55,56,54,55,56,54,30
30,48,49,50,48,49,50,48,49,50,48,49,50,48,49,50,48,49,50,48,49,50,48,49,50,48,49,50,48,49,50,48,49,50,48,49,50,48,49,50,48,49,50,48,49,50,48,49,50,48,49,50,48,49,50,48,49,50,48,49,50,48,49,50,48,49,50,48,49,50,48,49,50,48,49,50,48,49,50,48,49,50,48,49,50,48,49,50,48,49,50,48,49,50,48,49,50,48,49,50,48,49,50,48,49,50,48,49,50,48,49,50,48,49,50,48,49,50,48,30
30,54,55,56,54,55,56,54,55,56,54,55,56,54,55,56,54,55,56,54,55,56,54,55,56,54,55,56,54,55,56,54,55,56,54,55,56,54,55,56,54,55,56,54,55,56,54,55,56,54,55,56,54,55,56,54,55,56,54,55,56,54,55,56,54,55,56,54,55,56,54,55,56,54,55,56,54,55,56,54,55,56,54,55,56,54,55,56,54,55,56,54,55,56,54,55,56,54,55,56,54,55,56,54,55,56,54,55,56,54,55,56,54,55,56,54,55,56,54,30
30,48,49,50,48,49,50,48,49,50,48,49,50,48,49,50,48,49,50,48,49,50,48,49,50,48,49,50,48,49,50,48,49,50,48,49,50,48,49,50,48,49,50,48,49,50,48,49,50,48,49,50,48,49,50,48,49,50,48,49,50,48,49,50,48,49,50,48,49,50,48,49,50,48,49,50,48,49,50,48,49,50,48,49,50,48,49,50,48,49,50,48,49,50,48,49,50,48,49,50,48,49,50,48,49,50,48,49,50,48,49,50,48,49,50,48,49,50,48,30
30,54,55,56,54,55,56,54,55,56,54,55,56,54,55,56,54,55,56,54,55,56,54,55,56,54,55,56,54,55,56,54,55,56,54,55,56,54,55,56,54,55,56,54,55,56,54,55,56,54,55,56,54,55,56,54,55,56,54,55,56,54,55,56,54,55,56,54,55,56,54,55,56,54,55,56,54,55,56,54,55,56,54,55,56,54,55,56,54,55,56,54,55,56,54,55,56,54,55,56,54,55,56,54,55,56,54,55,56,54,55,56,54,55,56,54,55,56,54,30
42,44,44,44,44,44,44,44,44,44,44,44,44,44,44,44,44,44,44,44,44,44,44,44,44,44,44,44,44,44,44,44,44,44,44,44,44,44,44,44,44,44,44,44,44,44,44,44,44,44,44,44,44,44,44,44,44,44,44,44,44,44,44,44,44,44,44,44,44,44,44,44,44,44,44,44,44,44,44,44,44,44,44,44,44,44,44,44,44,44,44,44,44,44,44,44,44,44,44,44,44,44,44,44,44,44,44,44,44,44,44,44,44,44,44,44,44,44,44,42
